"filename", "language", "Rust", "JSON", "comment", "blank", "total"
"/Users/apple/rust-object/data_sync/src/Canister.json", "JSON", 0, 9, 0, 1, 10
"/Users/apple/rust-object/data_sync/src/PostProcess/EXT.rs", "Rust", 102, 0, 6, 35, 143
"/Users/apple/rust-object/data_sync/src/PostProcess/PUNK.rs", "Rust", 32, 0, 3, 16, 51
"/Users/apple/rust-object/data_sync/src/PostProcess/mod.rs", "Rust", 4, 0, 0, 0, 4
"/Users/apple/rust-object/data_sync/src/PostProcess/types/NFT.rs", "Rust", 149, 0, 16, 56, 221
"/Users/apple/rust-object/data_sync/src/PostProcess/types/mod.rs", "Rust", 1, 0, 0, 0, 1
"/Users/apple/rust-object/data_sync/src/PostProcess/utils.rs", "Rust", 22, 0, 2, 5, 29
"/Users/apple/rust-object/data_sync/src/QueryFunctions/DSWAP.rs", "Rust", 19, 0, 3, 9, 31
"/Users/apple/rust-object/data_sync/src/QueryFunctions/DataStructure/_DSWAP.rs", "Rust", 28, 0, 1, 11, 40
"/Users/apple/rust-object/data_sync/src/QueryFunctions/DataStructure/_EXT.rs", "Rust", 51, 0, 3, 12, 66
"/Users/apple/rust-object/data_sync/src/QueryFunctions/DataStructure/_PUNK.rs", "Rust", 37, 0, 0, 10, 47
"/Users/apple/rust-object/data_sync/src/QueryFunctions/DataStructure/mod.rs", "Rust", 3, 0, 0, 0, 3
"/Users/apple/rust-object/data_sync/src/QueryFunctions/EXT.rs", "Rust", 47, 0, 12, 21, 80
"/Users/apple/rust-object/data_sync/src/QueryFunctions/PUNK.rs", "Rust", 123, 0, 31, 44, 198
"/Users/apple/rust-object/data_sync/src/QueryFunctions/mod.rs", "Rust", 4, 0, 0, 0, 4
"/Users/apple/rust-object/data_sync/src/QueryThreads/EXT.rs", "Rust", 22, 0, 0, 8, 30
"/Users/apple/rust-object/data_sync/src/QueryThreads/PUNK.rs", "Rust", 33, 0, 0, 5, 38
"/Users/apple/rust-object/data_sync/src/QueryThreads/mod.rs", "Rust", 2, 0, 0, 1, 3
"/Users/apple/rust-object/data_sync/src/SQLProcess/NFT.rs", "Rust", 21, 0, 19, 18, 58
"/Users/apple/rust-object/data_sync/src/SQLProcess/mod.rs", "Rust", 1, 0, 0, 2, 3
"/Users/apple/rust-object/data_sync/src/SQLProcess/types/NFT.rs", "Rust", 0, 0, 0, 1, 1
"/Users/apple/rust-object/data_sync/src/SQLProcess/types/mod.rs", "Rust", 1, 0, 0, 2, 3
"/Users/apple/rust-object/data_sync/src/main.rs", "Rust", 26, 0, 22, 23, 71
"Total", "-", 728, 9, 118, 280, 1135