"filename", "language", "Rust", "SQL", "JSON", "comment", "blank", "total"
"/Users/apple/rust-object/data_sync/create_tables.sql", "SQL", 0, 58, 0, 0, 9, 67
"/Users/apple/rust-object/data_sync/src/Canister.json", "JSON", 0, 0, 9, 0, 1, 10
"/Users/apple/rust-object/data_sync/src/PostProcess/EXT.rs", "Rust", 161, 0, 0, 18, 43, 222
"/Users/apple/rust-object/data_sync/src/PostProcess/PUNK.rs", "Rust", 102, 0, 0, 6, 22, 130
"/Users/apple/rust-object/data_sync/src/PostProcess/mod.rs", "Rust", 4, 0, 0, 0, 0, 4
"/Users/apple/rust-object/data_sync/src/PostProcess/types/DFINANCE.rs", "Rust", 40, 0, 0, 2, 4, 46
"/Users/apple/rust-object/data_sync/src/PostProcess/types/NFT.rs", "Rust", 156, 0, 0, 17, 53, 226
"/Users/apple/rust-object/data_sync/src/PostProcess/types/mod.rs", "Rust", 10, 0, 0, 0, 2, 12
"/Users/apple/rust-object/data_sync/src/PostProcess/utils.rs", "Rust", 36, 0, 0, 2, 5, 43
"/Users/apple/rust-object/data_sync/src/QueryFunctions/DFINANCE/DSWAP.rs", "Rust", 123, 0, 0, 2, 23, 148
"/Users/apple/rust-object/data_sync/src/QueryFunctions/DFINANCE/DTOKEN.rs", "Rust", 75, 0, 0, 0, 15, 90
"/Users/apple/rust-object/data_sync/src/QueryFunctions/DFINANCE/REGISTRY.rs", "Rust", 30, 0, 0, 8, 10, 48
"/Users/apple/rust-object/data_sync/src/QueryFunctions/DFINANCE/STAKING.rs", "Rust", 88, 0, 0, 2, 20, 110
"/Users/apple/rust-object/data_sync/src/QueryFunctions/DFINANCE/mod.rs", "Rust", 4, 0, 0, 0, 0, 4
"/Users/apple/rust-object/data_sync/src/QueryFunctions/DataStructure/_DFINANCE/_DSWAP.rs", "Rust", 72, 0, 0, 2, 11, 85
"/Users/apple/rust-object/data_sync/src/QueryFunctions/DataStructure/_DFINANCE/_DTOKEN.rs", "Rust", 25, 0, 0, 0, 5, 30
"/Users/apple/rust-object/data_sync/src/QueryFunctions/DataStructure/_DFINANCE/_REGISTRY.rs", "Rust", 19, 0, 0, 0, 3, 22
"/Users/apple/rust-object/data_sync/src/QueryFunctions/DataStructure/_DFINANCE/_STAKING.rs", "Rust", 27, 0, 0, 0, 5, 32
"/Users/apple/rust-object/data_sync/src/QueryFunctions/DataStructure/_DFINANCE/mod.rs", "Rust", 4, 0, 0, 0, 0, 4
"/Users/apple/rust-object/data_sync/src/QueryFunctions/DataStructure/_EXT.rs", "Rust", 56, 0, 0, 3, 13, 72
"/Users/apple/rust-object/data_sync/src/QueryFunctions/DataStructure/_PUNK.rs", "Rust", 37, 0, 0, 0, 10, 47
"/Users/apple/rust-object/data_sync/src/QueryFunctions/DataStructure/_WALL.rs", "Rust", 12, 0, 0, 0, 11, 23
"/Users/apple/rust-object/data_sync/src/QueryFunctions/DataStructure/mod.rs", "Rust", 4, 0, 0, 0, 1, 5
"/Users/apple/rust-object/data_sync/src/QueryFunctions/EXT.rs", "Rust", 80, 0, 0, 11, 24, 115
"/Users/apple/rust-object/data_sync/src/QueryFunctions/PUNK.rs", "Rust", 168, 0, 0, 15, 45, 228
"/Users/apple/rust-object/data_sync/src/QueryFunctions/WALL.rs", "Rust", 33, 0, 0, 5, 10, 48
"/Users/apple/rust-object/data_sync/src/QueryFunctions/mod.rs", "Rust", 5, 0, 0, 0, 1, 6
"/Users/apple/rust-object/data_sync/src/SQLProcess/NFT.rs", "Rust", 145, 0, 0, 36, 32, 213
"/Users/apple/rust-object/data_sync/src/SQLProcess/mod.rs", "Rust", 1, 0, 0, 0, 2, 3
"/Users/apple/rust-object/data_sync/src/Threads/EXT.rs", "Rust", 35, 0, 0, 1, 13, 49
"/Users/apple/rust-object/data_sync/src/Threads/PUNK.rs", "Rust", 49, 0, 0, 4, 9, 62
"/Users/apple/rust-object/data_sync/src/Threads/mod.rs", "Rust", 2, 0, 0, 0, 1, 3
"/Users/apple/rust-object/data_sync/src/main.rs", "Rust", 24, 0, 0, 97, 34, 155
"Total", "-", 1627, 58, 9, 231, 437, 2362